22222222222222222
21111111111111112
21111222111111112
21111242111111112
21111212222111112
21122231342111112
21124301222111112
21122223211111112
21111124211111112
21111122211111112
21111111111111112
22222222222222222